   NO     Envie de   


SO  crever
WE   de con  

EA       parsing

C ,,,,,,,,,1,,,,,6,255,,

F 1,2,34

  11111111111
11100000011
1S000111111     
10000000011
10010101011
10111001111
101 1000011
111 1111111