C 5,5,255
WE de con    
NO image/north.xpm
SO crever
EA pars
F 26,255,4

11111111111
11111111111
11100000011
1S00000111
10000111011
100101 1011
10111111111
101 100011
111 1111111
11
11




