C 100,0,255


F 0,255,50

             WE./image/64x64.xpm                  
NO  ./image/bookshelf.xpm
SO ./image/BrickOv.xpm
EA ./image/Bricks.xpm 

111
11111111111
1 10000011
1110E0111
1010011111
1011000101
101110011111
101 1000111
101  11011111
1011  111
10111
10101
1111
