NO     Envie de





SO           crever     

WE   de con  

EA             parsing 

C 1,6,0

F 1,2,34



1
1
1
1
1
1
11111111111111111
10000000N11111
1111111111111111111