NO     Envie de


                


            SO           crever     

WE   de con  

EA             parsing 

C 1,6,0

F 1,2,34



     111111111
     1111000111111111111111111111111111111
   1111111111111
111111
11111111111
111       111
11111111111111111
10000000S11111
110011100111111111
101 100001
111 111111
111