C 5,5,255

                
WE ./image/chien.xpm                  

F 26,255,4

NO            ./image/chat.xpm

SO ./image/chat.xpm

EA ./image/chat.xpm
111
 10111111111
11100000011
1E00000111
100001111
100101 1011
101111111101
101 1000111
111  1111111
1111
11111
10001
11111