C 255,0,0

             WE./image/64x64.xpm                  

F 0,0,255

NO  ./image/bookshelf.xpm

SO ./image/BrickOv.xpm

EA ./image/Bricks.xpm 
111
 10111111111
11100000011
100S00111
100001111
100101 1011
101111111101
101 1000111
111  1111111
1111
11111
10001
11111
