C 5,5,255
WE de con    
F 26,255,4

NO image/north.xpm

SO crever

EA pars

          
111
  11111111111
11100000011
1S00000111
100001111
100101 1011
101111111101
101 1000111
111 1111111
11
11
1111
11111
111101
11111


