C 255,0,0

F 0,010,255


             WE ./image/64x64.xpm                  
NO  ./image/bookshelf.xpm
SO ./image/BrickOv.xpm
EA ./image/Bricks.xpm 


111
10111111111
10100000011
100000001
100S010111
10010101011
101111011101
101 1000111
101  1111111
1011  
10111
10001
11111
